TEAM ABBREVIATIONS
ATL - Atlanta Hawks
BKN - Brooklyn Nets
BOS - Boston Celtics
CHA - Charlotte Hornets
CHN - Charlotte Bobcats
CHI - Chicago Bulls
CLE - Cleveland Cavaliers
DAL - Dallas Mavericks
DEN - Denver Nuggets
DET - Detroit Pistons
GSW - Golden State Warriors
HOU - Houston Rockets
IND - Indiana Pacers
LAC - Los Angeles Clippers
LAL - Los Angeles Lakers
MEG - Memphis Grizzlies
MIA - Miami Heat
MIL - Milwaukee Bucks
MIN - Minnesota Timberwolves
NJN - New Jersey Nets
NOH - New Orleans Hornets
NOK - New Orleans/Oklahoma City Hornets
NOP - New Orleans Pelicans
NYK - New York Knickerbockers
ORL - Orlando Magic
PHI - Philadelphia 76ers
PHX - Phoenix Suns
POR - Portland Trailblazers
SAC - Sacramento Kings
SAN - San Antonio Spurs
SEA - Seattle Supersonics
TOR - Toronto Raptors
TRH - Toronto Huskies
UTA - Utah Jazz
VAN - Vancouver Grizzlies
WAS - Washington Wizards
WAS - Washington Bullets
